000|100|0|0|500|1
000|100|0|0|500|4
000|100|0|0|500|5
001|400|0|0|200|7
001|400|0|0|200|8